11111111
10001001
1E000CP1
11110111
