1111111111111111111111111
100000000000000C000000001
1E10010111100M001010MMM01
111111C0001111100010MMM01
1P00000M0C00C000M00000001
1111111111111111111111111
