11111111111111
1C0001P10000C1
10M10100000001
10010111111101
1M010000000001
10011111111111
10000M00000M01
1C00000000C1E1
11111111111111
