111111111111
100000000001
100111111001
1C0011100011
11101C000111
100C111100C1
1P0011E00011
111111111111
