1111111111
10000C0P01
1001111C11
1E0100C001
1111111111
