1111111111111
1000000000001
1M01111110001
1C00111M00101
11101C0001101
100C1110M1C01
1P0011E001101
1111111111111
