1111111111
1C000C0001
10011111C1
1E01P0C001
1111111111
